EU Airlines
Aegean Airlines - ICAO: AEE (Greece)
Aer Lingus - ICAO: EIN (Ireland)
Air Baltic - ICAO: BTI (Latvia)
Air Dolomiti - ICAO: DLA (Italy)
Air Europa - ICAO: AEA (Spain)
Air France - ICAO: AFR (France)
Air Malta - ICAO: AMC (Malta)
Air Nostrum - ICAO: ANE (Spain)
Air Serbia - ICAO: ASL (Serbia)
ITA Airways - ICAO: ITY (Italy)
Austrian Airlines - ICAO: AUA (Austria)
Blue Air - ICAO: BMS (Romania)
British Airways - ICAO: BAW (United Kingdom)
Brussels Airlines - ICAO: DAT (Belgium)
Condor - ICAO: CFG (Germany)
Croatia Airlines - ICAO: CTN (Croatia)
Czech Airlines - ICAO: CSA (Czech Republic)
easyJet - ICAO: EZY (United Kingdom)
Eurowings - ICAO: EWG (Germany)
Finnair - ICAO: FIN (Finland)
Iberia - ICAO: IBE (Spain)
Jet2.com - ICAO: EXS (United Kingdom)
KLM Royal Dutch Airlines - ICAO: KLM (Netherlands)
LOT Polish Airlines - ICAO: LOT (Poland)
Lufthansa - ICAO: DLH (Germany)
Luxair - ICAO: LGL (Luxembourg)
Norwegian Air Shuttle - ICAO: NAX (Norway)
Ryanair - ICAO: RYR (Ireland)
SAS-Scandinavian Airlines - ICAO: SAS (Denmark, Sweden, Norway)
Swiss International Air Lines - ICAO: SWR (Switzerland)
TAP Air Portugal - ICAO: TAP (Portugal)
Transavia - ICAO: TRA (Netherlands)
TUI Airways - ICAO: TOM (United Kingdom)
Virgin Atlantic - ICAO: VIR (United Kingdom)
Vueling - ICAO: VLG (Spain)
Wizz Air - ICAO: WZZ (Hungary)
Non-EU Airlines 
Aeroflot - ICAO: AFL (Russia)
Air Canada - ICAO: ACA (Canada)
Air India - ICAO: AIC (India)
All Nippon Airways (ANA) - ICAO: ANA (Japan)
American Airlines - ICAO: AAL (United States)
Asiana Airlines - ICAO: AAR (South Korea)
Cathay Pacific - ICAO: CPA (Hong Kong)
Delta Air Lines - ICAO: DAL (United States)
EgyptAir - ICAO: MSR (Egypt)
El Al Israel Airlines - ICAO: ELY (Israel)
Emirates - ICAO: UAE (United Arab Emirates)
Etihad Airways - ICAO: ETD (United Arab Emirates)
Ethiopian Airlines - ICAO: ETH (Ethiopia)
Japan Airlines - ICAO: JAL (Japan)
Kenya Airways - ICAO: KQA (Kenya)
Korean Air - ICAO: KAL (South Korea)
Middle East Airlines (MEA) - ICAO: MEA (Lebanon)
Qantas - ICAO: QFA (Australia)
Qatar Airways - ICAO: QTR (Qatar)
Royal Air Maroc - ICAO: RAM (Morocco)
Singapore Airlines - ICAO: SIA (Singapore)
South African Airways - ICAO: SAA (South Africa)
SriLankan Airlines - ICAO: ALK (Sri Lanka)
Thai Airways - ICAO: THA (Thailand)
Turkish Airlines - ICAO: THY (Turkey)
United Airlines - ICAO: UAL (United States)
Uzbekistan Airways - ICAO: UZB (Uzbekistan)
Vietnam Airlines - ICAO: HVN (Vietnam)
WestJet - ICAO: WJA (Canada)
China Eastern Airlines - ICAO: CES (China)
China Southern Airlines - ICAO: CSN (China)
Hainan Airlines - ICAO: CHH (China)
Garuda Indonesia - ICAO: GIA (Indonesia)
Air Transat - ICAO: TSC (Canada)
Air Mauritius - ICAO: MAU (Mauritius)
Pakistan International Airlines - ICAO: PIA (Pakistan)
Philippine Airlines - ICAO: PAL (Philippines)
Saudia - ICAO: SVA (Saudi Arabia)
Oman Air - ICAO: OMA (Oman)
